gn.####..d..g###h#.ss#mmmg
ss......########.#.#ssmmmh
##..m##.#mmmmssss#.#######
##..m##.#...m#####.#...#sd
m....s#...#mt#.......#.#s#
m....s###...##.###s###.#s#
###d#s#####.##.......#.#s#
#####s#####....#####d#...#
#####s########sss....###.#
g...ds#t.#######.mnm.###ns
....####.##sss##.ngn.###ns
..@.........np##.mnm.###ns
#######.##.#####.....###f#
#sssss..##....h#.#########