###########
..........#
...#.#....#
####.######
#...@.....#
...#.###..#
.##....#..#
..##...#..#
#..#####..#
##........#
###########